allen-p	philip.allen@enron.com	Philip Allen	
arnold-j	john.arnold@enron.com	John Arnold	Vice President
arora-h	harpreet.arora@enron.com	Harpreet Arora	Vice President
badeer-r	robert.badeer@enron.com	Robert Badeer	Director
bailey-s	susan.bailey@enron.com	Susan Bailey	
bass-e	eric.bass@enron.com	Eric Bass	Trader
baughman-d	don.baughman@enron.com	Don Baughman	Trader
beck-s	sally.beck@enron.com	Sally Beck	Chief Operating Officer
benson-r	robert.benson@enron.com	Robert Benson	Director
blair-l	lynn.blair@enron.com	Lynn Blair	
brawner-s	sandra.brawner@enron.com	Sandra Brawner	Director
buy-r	rick.buy@enron.com	Rick Buy	Manager, Chief Risk Management Officer
campbell-l	larry.campbell@enron.com	Larry Campbell	
carson-m	mike.carson@enron.com	Mike Carson	
cash-m	michelle.cash@enron.com	Michelle Cash	
causholli-m	monika.causholli@enron.com	Monika Causholli	Analyst Risk Management
corman-s	shelley.corman@enron.com	Shelley Corman	Vice President, Regulatory Affairs
crandall-s	sean.crandall@enron.com	Sean Crandall	Director
cuilla-m	martin.cuilla@enron.com	Martin Cuilla	Manager
dasovich-j	jeff.dasovich@enron.com	Jeff Dasovich	Government Relation Executive
davis-d	dana.davis@enron.com	Dana Davis	
dean-c	craig.dean@enron.com	Craig Dean	Trader
delainey-d	david.delainey@enron.com	David Delainey	CEO, Enron North America and Enron Energy Services
derrick-j	james.derrick@enron.com	James Derrick	General Counsel
dickson-s	stacy.dickson@enron.com	Stacy Dickson	
donoho-l	lindy.donoho@enron.com	Lindy Donoho	
donohoe-t	tom.donohoe@enron.com	Tom Donohoe	
dorland-c	chris.dorland@enron.com	Chris Dorland	
ermis-f	frank.ermis@enron.com	Frank Ermis	Director
farmer-d	daren.farmer@enron.com	Daren Farmer	Manager, Logistics Manager
fischer-m	mary.fischer@enron.com	Mary Fischer	
forney-j	john.forney@enron.com	John M. Forney	Manager, Real-Time Trading Desk
fossum-d	drew.fossum@enron.com	Drew Fossum	Vice President
gang-l	lisa.gang@enron.com	Lisa Gang	Senior Specialist
gay-r	randall.gay@enron.com	Randall Gay	
geaccone-t	tracy.geaccone@enron.com	Tracy Geaccone	
germany-c	chris.germany@enron.com	Chris Germany	
gilbertsmith-d	douglas.gilberthsmith@enron.com	Douglas Gilberth-Smith	Manager
giron-d	daron.giron@enron.com	Daron Giron	
griffith-j	john.giffith@enron.com	John Giffith	Managing Director, MD of UK
grigsby-m	michael.grigsby@enron.com	Michael Grigsby	Manager
guzman-m	mark.guzman@enron.com	Mark Guzman	Trader
haedicke-m	mark.haedicke@enron.com	Mark Haedicke	Managing Director, Legal Department
hain-m	mary.hain@enron.com	Mary C. Hain	In House Lawyer
harris-s	steven.harris@enron.com	Steven Harris	
hayslett-r	rod.hayslett@enron.com	Rod Hayslett	Vice President, Chief Financial Officer and Treasurer
heard-m	marie.heard@enron.com	Marie Heard	
hendrickson-s	scott.hendrickson@enron.com	Scott Hendrickson	
hernandez-j	juan.hernandez@enron.com	Juan Hernandez	
hodge-j	john.hodge@enron.com	John Hodge	Managing Director
holst-k	keith.holst@enron.com	Keith Holst	Director
horton-s	stanley.horton@enron.com	Stanley Horton	President, Enron Gas Pipeline
hyatt-k	kevin.hyatt@enron.com	Kevin Hyatt	Director, Pipeline Business
hyvl-d	dan.hyvl@enron.com	Dan Hyvl	
jones-t	tana.jones@enron.com	Tana Jones	
kaminski-v	vince.kaminski@enron.com	Vince Kaminski	Manager, Risk Management Head
kean-s	steven.kean@enron.com	Steven Kean	Vice President, Vice President & Chief of Staff
keavey-p	peter.keavey@enron.com	Peter Keavey	
keiser-k	kam.keiser@enron.com	Kam Keiser	
king-j	jeff.king@enron.com	Jeff King	Manager
kitchen-l	louise.kitchen@enron.com	Louise Kitchen	President, Enron Online
kuykendall-t	tori.kuykendall@enron.com	Tori Kuykendall	Trader
lavorato-j	john.lavorato@enron.com	John Lavorato	CEO, Enron America
lay-k	kenneth.lay@enron.com	Kenneth Lay	CEO
lenhart-m	matthew.lenhart@enron.com	Matthew Lenhart	
lewis-a	andrew.lewis@enron.com	Andrew Lewis	Director
linder-e	eric.linder@enron.com	Eric Linder	Specialist
lokay-m	michelle.lokay@enron.com	Michelle Lokay	Administrative Assistant
lokey-t	teb.lokey@enron.com	Teb Lokey	Manager, Regulatory Affairs
love-p	phillip.love@enron.com	Phillip Love	
lucci-p	paul.lucci@enron.com	Paul Lucci	
maggi-m	michael.maggi@enron.com	Michael Maggi	Director
mann-k	kay.mann@enron.com	Kay Mann	
martin-t	thomas.martin@enron.com	Thomas Martin	Vice President
may-l	lawrence.may@enron.com	Lawrence May	Director
mccarty-d	danny.mccarty@enron.com	Danny McCarty	Vice President
mcconnell-m	mike.mcconnell@enron.com	Mike McConnell	
mckay-b	bradley.mckay@enron.com	Bradley Mckay	
mckay-j	jonathan.mckay@enron.com	Jonathan Mckay	Director
mclaughlin-e	errol.mclaughlin@enron.com	Errol McLaughlin	
merriss-s	steven.merriss@enron.com	Steven Merriss	Specialist
meyers-a	albert.meyers@enron.com	Albert Meyers	
mims-thurston-p	patrice.mimsthurston@enron.com	Patrice Mims-Thurston	
motley-m	matthew.motley@enron.com	Matthew Motley	Director
neal-s	scott.neal@enron.com	Scott Neal	Vice President
nemec-g	gerald.nemec@enron.com	Gerald Nemec	
panus-s	stephanie.panus@enron.com	Stephanie Panus	
parks-j	joe.parks@enron.com	Joe Parks	
pereira-s	susan.pereira@enron.com	Susan Pereira	
perlingiere-d	debra.perlingiere@enron.com	Debra Perlingiere	
pimenov-v	vladi.pimenov@enron.com	Vladi Pimenov	
platter-p	phillip.platter@enron.com	Phillip Platter	Sr. Specialist
presto-k	kevin.presto@enron.com	Kevin Presto	Vice President
quenet-j	joe.quenet@enron.com	Joe Quenet	Trader
quigley-d	dutch.quigley@enron.com	Dutch Quigley	
rapp-b	bill.rapp@enron.com	Bill Rapp	
reitmeyer-j	jay.reitmeyer@enron.com	Jay Reitmeyer	
richey-c	cooper.richey@enron.com	Cooper Richey	Manager
ring-a	andrea.ring@enron.com	Andrea Ring	
ring-r	richard.ring@enron.com	Richard Ring	
rodrigue-r	robin.rodrigue@enron.com	Robin Rodrigue	
rogers-b	benjamin.rogers@enron.com	Benjamin Rogers	
ruscitti-k	kevin.ruscitti@enron.com	Kevin Ruscitti	Trader
sager-e	elizabeth.sager@enron.com	Elizabeth Sager	
saibi-e	eric.saibi@enron.com	Eric Saibi	Trader
salisbury-h	holden.salisbury@enron.com	Holden Salisbury	Cash Analyst
sanchez-m	monique.sanchez@enron.com	Monique Sanchez	
sanders-r	richard.sanders@enron.com	Richard Sanders	Vice President, Enron Wholesale Services
scholtes-d	diana.scholtes@enron.com	Diana Scholtes	Trader
schoolcraft-d	darrell.schoolcraft@enron.com	Darrell Schoolcraft	
schwieger-j	jim.schwieger@enron.com	Jim Schwieger	Trader
scott-s	susan.scott@enron.com	Susan Scott	
semperger-c	cara.semperger@enron.com	Cara Semperger	Senior Analyst Cash
shackleton-s	sara.shackleton@enron.com	Sara Shackleton	
shankman-j	jeffrey.shankman@enron.com	Jeffrey Shankman	President, Enron Global Markets
shapiro-r	richard.shapiro@enron.com	Richard Shapiro	Vice President, Regulatory Affairs
shively-h	hunter.shively@enron.com	Hunter Shively	Vice President
skilling-j	jeffery.skilling@enron.com	Jeffery Skilling	CEO
slinger-r	ryan.slinger@enron.com	Ryan Slinger	Trader
smith-m	matt.smith@enron.com	Matt Smith	
solberg-g	geir.solberg@enron.com	Geir Solberg	
south-s	steven.south@enron.com	Steven P. South	
staab-t	theresa.staab@enron.com	Theresa Staab	
stclair-c	carol.stclair@enron.com	Carol St. Clair	In House Lawyer
steffes-j	james.steffes@enron.com	James Steffes	Vice President, Government Affairs
stepenovitch-j	joe.stepenovitch@enron.com	Joe Stepenovitch	Vice President, Energy Marketing and Trading Florida
stokley-c	chris.stokley@enron.com	Chris Stokley	
storey-g	geoffery.storey@enron.com	Geoffery Storey	Director
sturm-f	fletcher.sturm@enron.com	Fletcher Sturm	Vice President
swerzbin-m	mike.swerzbin@enron.com	Mike Swerzbin	Trader
symes-k	kate.symes@enron.com	Kate Symes	
taylor-m	mark.taylor@enron.com	Mark Taylor	
tholt-j	jane.tholt@enron.com	Jane Tholt	Vice President
thomas-p	paul.thomas@enron.com	Paul Thomas	
townsend-j	judy.townsend@enron.com	Judy Townsend	
tycholiz-b	barry.tycholiz@enron.com	Barry Tycholiz	Vice President
ward-k	kim.ward@enron.com	Kim Ward	
watson-k	kimberly.watson@enron.com	Kimberly Watson	
weldon-c	charles.weldon@enron.com	Charles Weldon	
whalley-g	lawrence.whalley@enron.com	Lawrence Greg Whalley	President
white-s	stacey.white@enron.com	Stacey White	
whitt-m	mark.whitt@enron.com	Mark Whitt	
williams-j	jason.williams@enron.com	Jason Williams	Trading
williams-w3	william.whalley@enron.com	William Whalley Williams	Senior Analyst
wolfe-j	jason.wolfe@enron.com	Jason Wolfe	
ybarbo-p	paul.ybarbo@enron.com	Paul Y'Barbo	
zipper-a	andy.zipper@enron.com	Andy Zipper	Vice President, Enron Online
zufferli-j	john.zufferli@enron.com	John Zufferli	
